-17
31
-12
7
0000000000000000000000000000000000000000000000000
1111111111111111111111111111111111111111111111110
0000000000000000000000000000000000000000000000000
0000000000000000000000000000110000000000000000000
0000000000000000000011111110000000000000000000000
0000000000000000000011111110000000000000000000000
0000000000000100000011111110000000000000000000000
0000000000000000000011111110000000000010001000000
0000000011000000000011111110000000000000000000000
0000000000000000000011111110000000000000000000000
0000000000000000000011111110000000000000000000000
0000000000000000000000000000000000000000000000000
0000000000011000000000000000000000000000000000000
0000000000000000000000000000000000000000001000000
0000000000000000000000000000000000000000000000000
0000000000000000000000000000000111000000000000000
0000000000000000000000000000000000000111000000000
0000000000000000000000000000000000000000000000000
0000000000000000000000000000000000000000000000000
0000000000000000000000000000000000000110001000000
