-17
33
-14
7
000000000000000000000000000000000000000000000000000
111111111111111111111111111111111111111111111111100
100000000000000000000000000000000000000000000000100
100000000000000000000000000011000000000000000000100
100000000000000000001111111000000000000000000000100
100000000000000000001111111000000000000000000000100
100000000000010000001111111000000000000000000000100
100000000000000000001111111000000000001000100000100
100000001100000000001111111000000000000000000000100
100000000000000000001111111000000000000000000000100
100000000000000000001111111000000000000000000000100
100000000000000000000000000000000000000000000000100
100000000001100000000000000000000000000000000000100
100000000000000000000000000000000000000000100000100
100000000000000000000000000000000000000000000000100
100000000000000000000000000000011100000000000000100
100000000000000000000000000000000000011100000000100
100000000000000000000000000000000000000000000000100
100000000000000000000000000000000000000000000000100
100000000000000000000000000000000000011000100000100
100000000000000000000000000000000000000000000000100
100000000000000000000000000000000000000000000000100
